9 9
0 0 0 0 1 1 1 1 1 
0 0 0 1 1 0 0 0 1 
0 0 1 1 0 3 4 0 1 
0 1 1 0 0 0 0 0 33 
1 1 0 0 0 0 0 0 1 
1 0 0 0 5 0 0 0 1 
1 0 0 0 0 0 0 0 1 
1 0 0 0 0 0 0 0 1 
1 1 44 1 1 55 1 1 1 