9 10
1 1 1 1 44 1 1 1 0 
1 0 0 0 0 0 0 1 0 
1 0 3 0 0 0 0 1 0 
1 0 3 0 0 0 0 1 0 
33 0 0 0 0 0 0 1 1 
1 0 0 0 0 4 0 0 1 
1 0 0 0 0 0 0 0 1 
1 0 0 0 4 0 0 0 1 
1 0 0 1 0 0 1 1 1 
1 1 1 1 1 1 1 0 0 