8 12
0 0 1 1 1 1 0 0 
0 0 1 3 0 1 0 0 
1 1 1 0 0 1 1 1 
1 0 0 0 0 0 0 33 
55 0 0 0 0 4 0 1 
1 0 0 0 0 0 0 1 
1 0 0 0 0 0 0 1 
44 0 0 0 0 5 0 1 
1 0 0 0 0 0 0 1 
1 1 1 0 0 1 1 1 
0 0 1 0 0 1 0 0 
0 0 1 1 1 1 0 0 