12 12
1 1 1 1 1 1 22 1 1 1 1 1 
1 0 0 0 5 0 0 0 0 0 0 1 
1 0 0 0 0 0 0 0 0 0 0 1 
33 0 0 0 0 0 0 0 0 0 1 1 
1 0 0 0 0 0 0 4 0 0 0 1 
1 0 0 1 0 0 0 0 0 0 0 1 
1 0 1 0 0 0 0 0 0 0 0 1 
1 0 0 0 0 3 0 0 0 0 0 55 
1 0 0 0 0 0 0 0 0 0 0 1 
1 0 0 1 0 0 0 0 0 0 2 1 
1 0 3 0 0 0 0 0 0 0 0 1 
1 1 1 1 1 44 1 1 1 1 1 1 