13 13
1 1 1 22 1 1 1 1 1 1 1 1 1 
1 2 0 6 0 0 0 0 0 0 0 1 1 
1 0 0 0 33 0 0 0 0 0 0 0 1 
1 0 1 0 1 0 1 0 0 0 0 0 1 
1 0 1 0 1 0 1 0 1 0 0 0 1 
1 0 1 0 1 0 1 0 1 0 0 0 1 
1 0 1 0 1 0 1 0 1 0 0 0 1 
1 0 0 0 1 0 1 0 1 0 0 0 1 
1 0 0 0 0 0 44 0 0 0 0 0 1 
1 0 4 0 0 0 0 0 0 0 0 0 1 
1 0 0 0 0 0 0 0 0 0 0 0 1 
1 0 0 0 0 0 3 0 0 0 0 0 1 
1 1 1 1 1 1 1 1 66 1 1 1 1 