13 13
1 1 1 1 1 1 1 1 1 1 1 1 1 
1 0 0 0 0 0 0 0 0 0 0 0 1 
1 0 0 0 0 0 0 0 0 0 0 0 1 
1 0 0 33 1 1 1 1 1 0 0 0 1 
1 0 0 1 44 44 44 44 1 0 0 0 1 
1 0 0 1 44 44 44 44 1 0 0 0 1 
1 0 0 1 44 44 44 44 1 0 0 0 1 
1 0 0 1 44 44 44 1 1 0 0 0 1 
1 0 0 1 1 1 1 1 1 0 0 0 1 
1 0 0 0 0 0 0 0 0 1 0 0 1 
1 0 0 0 0 5 3 0 0 0 0 0 1 
1 0 0 0 0 0 0 0 0 0 0 0 1 
1 1 55 1 1 1 1 1 1 1 1 1 1 