13 13
33 33 33 33 33 33 33 33 66 33 33 33 33 
33 0 0 0 0 0 0 0 4 0 0 0 33 
33 0 0 0 0 0 0 0 0 0 0 0 22 
44 0 0 0 0 0 0 0 0 0 0 0 33 
33 0 0 1 6 0 1 0 0 1 0 0 33 
33 0 0 33 33 55 33 33 33 33 0 0 33 
33 0 0 33 33 55 33 33 33 33 0 0 33 
33 0 0 55 55 55 55 55 55 55 0 0 33 
33 0 0 33 33 55 33 33 33 33 0 0 33 
33 0 0 33 33 55 33 33 33 33 0 0 33 
33 0 0 0 0 0 0 0 2 0 0 0 33 
33 0 0 0 0 0 0 0 0 0 0 0 33 
33 33 33 33 33 33 33 33 33 33 33 33 33 