13 13
1 1 1 1 1 1 1 1 1 1 1 1 1
1 1 0 0 0 0 0 0 0 0 0 1 1 
1 0 0 0 0 0 1 0 0 0 0 0 1 
1 0 0 0 44 0 1 0 55 0 0 0 1 
1 0 0 0 0 0 1 0 0 0 0 0 1 
1 0 1 5 0 0 1 0 0 4 1 0 1 
1 0 1 0 0 0 1 0 0 0 1 0 1 
1 0 1 0 5 0 1 0 4 0 1 0 1 
1 0 1 1 1 3 1 3 1 1 1 0 1 
1 0 1 1 1 1 1 1 1 1 1 0 1 
1 0 0 0 0 0 33 0 0 0 0 0 1 
1 0 0 0 0 0 0 0 0 0 0 0 1 
1 1 1 1 1 1 1 1 1 1 1 1 1 