13 13
1 1 1 1 1 1 1 1 1 1 1 1 1 
1 77 77 1 6 0 0 0 4 1 77 77 1 
1 77 1 1 0 0 0 0 0 1 1 77 1 
1 1 1 0 0 0 0 0 0 0 1 1 1 
1 3 0 0 0 0 0 0 0 0 0 2 1 
1 0 0 0 0 1 1 33 0 0 0 0 1 
1 0 0 0 0 1 1 1 0 0 0 0 1 
1 0 0 0 0 66 1 44 0 0 0 0 1 
22 4 0 0 0 0 0 0 0 0 0 6 1 
1 1 1 0 0 0 0 0 0 0 1 1 1 
1 77 1 1 0 0 0 0 0 1 1 77 1 
1 77 77 1 2 0 0 0 3 1 77 77 1 
1 1 1 1 1 1 1 1 1 1 1 1 1 