13 13
1 1 1 1 1 1 1 1 1 1 1 1 1 
1 0 0 1 0 0 4 0 0 0 0 0 1 
1 5 1 1 1 1 0 0 0 0 0 0 1 
1 0 1 0 0 0 0 0 1 1 0 0 1 
1 0 1 0 1 1 0 0 0 1 0 0 1 
1 0 0 0 1 0 0 0 0 0 0 0 1 
55 0 0 0 0 0 0 0 1 0 0 0 1 
1 0 0 0 0 0 0 1 1 0 1 0 1 
1 0 0 1 0 0 0 6 0 0 1 0 1 
1 0 0 1 1 0 0 0 1 1 1 0 1 
1 0 0 22 1 0 0 0 1 66 1 0 1 
1 0 2 0 0 0 0 0 0 0 0 0 1 
1 1 1 44 1 1 1 1 1 1 1 1 1 