13 13
1 1 1 1 1 1 1 1 1 1 1 1 1 
1 0 0 0 0 0 0 0 0 0 0 0 1 
1 0 33 33 0 44 0 0 0 33 33 0 1 
1 0 5 33 0 44 44 0 0 33 33 0 1 
1 0 0 33 0 44 0 0 0 0 0 0 1 
1 0 0 0 0 0 0 0 66 44 0 0 1 
1 0 2 0 44 0 0 0 0 44 22 0 1 
1 0 33 2 44 44 0 0 0 0 0 0 1 
1 0 33 0 6 44 0 33 0 0 0 0 1 
1 0 55 0 0 0 0 33 5 0 0 0 1 
1 0 33 0 0 0 33 33 0 0 0 0 1 
1 0 0 0 0 0 0 0 6 0 0 0 1 
1 1 1 1 1 1 1 1 1 1 1 1 1 