13 13
1 1 1 1 1 1 55 1 1 1 1 1 1 
1 0 0 0 0 0 0 0 0 0 0 0 1 
1 0 0 0 33 33 0 33 33 5 0 0 1 
1 0 0 33 0 33 0 33 0 33 0 0 1 
1 0 33 0 0 33 0 33 0 0 33 0 1 
1 0 33 0 66 33 0 33 66 0 33 0 1 
1 0 33 0 0 33 0 33 0 0 33 0 1 
1 0 33 0 33 0 0 2 33 0 33 0 22 
1 7 33 33 0 0 0 0 0 33 33 0 77 
1 0 0 0 0 0 0 0 0 0 0 0 1 
1 0 0 0 0 44 44 44 0 0 0 0 1 
1 0 0 0 0 0 0 0 0 0 0 0 1 
1 1 1 1 1 1 1 1 1 1 1 1 1 