13 13
1 1 1 1 1 1 1 1 1 1 1 1 1 
1 0 5 0 0 0 0 0 0 0 0 4 1 
1 0 0 55 1 1 1 1 1 1 1 0 1 
1 0 0 0 0 0 0 0 0 0 1 0 1 
1 0 0 1 1 1 1 1 1 0 1 0 1 
1 0 0 1 0 0 0 0 1 0 1 0 1 
1 0 0 1 0 1 33 0 1 0 1 0 1 
1 0 0 1 0 1 44 0 1 0 1 0 1 
1 0 0 1 0 1 1 1 1 0 1 0 1 
1 0 0 1 0 0 0 0 0 0 1 0 1 
1 0 0 1 1 1 1 1 1 1 1 0 1 
1 3 0 0 0 0 0 0 0 0 0 0 1 
1 1 1 1 1 1 1 1 1 1 1 1 1 