13 13
1 1 1 1 1 1 1 1 1 1 1 1 77 
1 0 0 0 0 0 0 6 33 1 1 77 77 
1 0 1 1 1 1 1 1 1 1 77 77 77 
1 0 0 0 0 0 0 4 55 1 77 77 77 
1 0 1 1 1 1 1 1 1 1 77 77 77 
1 0 1 1 1 1 1 1 1 1 77 77 77 
1 0 2 0 0 0 22 1 77 77 77 77 77 
1 0 1 1 1 1 1 1 1 1 77 77 77 
1 0 1 1 1 1 1 1 1 1 77 77 77 
1 0 0 0 0 0 0 5 66 1 77 77 77 
1 0 1 1 1 1 1 1 1 1 77 77 77 
1 0 0 0 0 0 0 3 44 1 1 77 77 
1 1 1 1 1 1 1 1 1 1 1 1 77 