13 13
55 55 55 1 1 1 1 1 1 55 55 55 55 
55 55 55 55 0 0 0 0 0 0 66 66 66 
55 55 55 0 55 0 0 0 0 0 66 66 66 
1 55 0 55 0 0 0 0 0 0 0 66 0 
1 0 55 0 0 0 0 0 0 0 66 66 66 
1 0 0 0 0 2 55 55 66 66 66 66 66 
1 0 0 3 0 7 33 55 0 0 66 66 66 
1 0 0 0 0 0 77 55 66 66 66 66 66 
22 0 0 0 0 0 0 0 0 0 66 66 66 
1 0 0 0 0 0 0 0 0 66 66 66 66 
1 0 0 0 0 0 0 0 0 66 0 0 66 
1 0 4 0 0 0 0 0 66 66 0 0 66 
1 1 1 44 1 1 1 1 1 1 1 66 66 