13 13
1 1 1 1 1 1 1 1 1 1 1 1 1 
1 0 0 6 0 0 0 0 0 4 0 0 1 
1 1 44 0 0 0 0 0 0 0 33 1 1 
1 0 0 0 0 22 22 22 0 0 0 0 1 
1 0 0 0 22 0 22 0 22 0 0 0 1 
1 0 0 22 0 0 22 0 0 22 0 0 1 
1 0 0 22 0 0 22 0 0 22 0 0 1 
1 0 0 22 0 22 0 22 0 22 0 0 1 
1 0 0 0 22 0 0 0 22 0 0 0 1 
1 0 0 0 0 22 22 22 0 0 0 0 1 
1 1 55 0 0 0 0 0 0 0 66 1 1 
1 3 0 0 0 0 0 0 0 0 0 5 1 
1 1 1 1 1 1 1 1 1 1 1 1 1 