13 13
1 1 1 1 1 1 1 1 1 1 1 1 1 
55 0 0 0 0 0 0 0 0 0 0 6 1 
1 0 0 0 0 0 0 0 0 0 0 0 1 
33 33 33 0 33 7 0 33 0 33 0 33 33 
33 0 33 0 33 0 0 33 0 33 0 33 0 
33 0 33 0 33 0 0 33 0 33 0 33 33 
33 33 33 0 33 0 0 33 0 33 0 33 0 
33 0 33 0 33 0 0 33 0 33 0 33 0 
33 33 33 0 33 33 0 33 33 33 0 33 33 
1 0 0 0 0 0 0 0 0 0 0 0 77 
66 0 0 0 0 0 0 0 0 0 2 0 1 
1 0 0 0 0 0 0 0 0 0 5 0 1 
1 1 1 1 1 1 1 1 22 1 1 1 1 