13 13
44 44 44 44 44 44 44 44 44 44 44 44 44 
44 44 0 0 0 0 0 0 0 0 0 0 44 
44 0 1 3 0 0 0 0 0 0 1 0 44 
44 0 0 22 0 0 0 0 0 1 0 0 44 
44 0 0 0 55 2 0 0 33 0 0 0 44 
44 0 0 0 0 1 0 1 0 0 0 0 44 
44 0 5 0 0 0 1 0 0 0 0 0 44 
44 0 0 0 0 0 1 0 0 0 0 0 44 
44 0 0 0 0 0 1 0 0 0 0 0 44 
44 0 0 0 1 1 1 1 1 0 0 0 44 
44 0 0 0 0 0 0 0 0 0 0 0 44 
44 0 0 0 0 0 3 0 0 0 0 0 44 
44 44 44 44 44 44 44 44 44 44 44 44 44 