13 13
1 1 1 1 1 1 1 1 1 33 1 1 1 
1 0 0 0 0 0 0 0 0 0 0 0 1 
1 0 0 0 0 44 44 44 0 0 0 0 1 
1 0 0 0 0 44 44 44 0 0 0 0 1 
66 0 0 2 7 44 44 44 0 0 0 0 55 
1 0 44 44 44 44 44 44 44 44 44 0 1 
1 0 44 44 44 44 44 44 44 44 44 0 1 
1 0 44 44 44 44 44 44 44 44 44 0 1 
1 0 0 0 5 44 44 44 3 6 0 0 22 
1 0 0 0 0 44 44 44 0 0 0 0 1 
1 0 0 0 0 44 44 44 0 0 0 0 1 
1 0 0 0 0 0 0 0 0 0 0 0 1 
1 1 1 1 77 1 1 1 1 1 1 1 1 