13 13
1 1 1 1 1 1 1 1 1 1 1 1 1 
1 1 1 0 0 0 0 0 0 0 0 0 1 
1 0 1 1 0 0 0 0 0 0 0 0 1 
1 0 0 1 1 0 0 0 0 0 0 0 1 
1 0 0 0 1 1 0 0 0 0 0 0 1 
1 0 0 0 0 0 0 0 0 0 0 4 1 
1 0 0 0 0 0 1 22 0 0 0 0 1 
1 0 0 0 0 0 0 1 1 0 0 0 1 
1 0 0 0 0 0 0 0 1 1 0 0 1 
1 0 0 0 0 0 0 0 0 1 1 0 1 
1 0 0 0 0 0 0 0 0 0 1 1 1 
1 0 0 0 0 0 0 0 0 0 2 1 1 
1 1 1 1 1 1 1 1 1 1 44 1 1 