13 13
22 1 1 1 1 1 1 1 1 1 1 1 22 
1 0 0 0 0 0 0 0 0 0 0 2 1 
1 0 0 0 0 0 0 0 0 1 1 0 1 
1 0 1 1 0 0 0 0 0 1 1 0 1 
1 0 22 22 22 22 22 22 22 22 22 0 1 
1 0 22 0 0 0 0 3 0 0 22 0 1 
1 0 22 0 0 0 0 0 0 0 22 0 1 
1 0 22 22 22 0 22 22 22 22 22 0 1 
1 0 44 1 0 0 0 0 0 1 1 0 1 
1 0 0 0 0 0 0 0 0 33 1 0 1 
1 0 0 0 0 0 0 0 0 0 0 0 1 
1 0 0 0 0 0 1 0 0 0 0 4 1 
22 1 1 1 1 1 1 1 1 1 1 1 22 