13 13
33 44 33 44 33 44 33 44 33 44 33 44 33 
44 5 0 0 0 0 0 0 0 0 0 0 44 
33 0 44 0 33 0 44 0 33 0 44 0 33 
44 0 0 0 0 0 33 0 0 0 0 0 44 
33 0 33 0 0 0 44 4 0 0 33 0 33 
44 0 0 0 0 0 0 0 0 0 0 0 44 
33 0 44 33 44 0 22 0 44 33 44 0 33 
44 0 0 0 0 0 0 0 0 0 0 0 55 
33 0 33 0 0 0 44 0 0 0 33 0 33 
44 0 0 0 0 0 33 0 0 0 0 0 44 
33 0 44 0 33 3 44 0 33 2 44 0 33 
44 0 0 0 0 0 0 0 0 0 0 0 44 
33 44 33 44 33 44 33 44 33 44 33 44 33 