13 13
22 1 55 1 44 1 33 1 66 1 77 1 1 
1 0 0 0 0 0 0 0 0 0 0 0 1 
55 0 22 0 55 0 44 0 33 0 66 0 77 
1 0 0 0 0 0 0 0 0 0 0 0 1 
44 0 55 0 22 0 55 0 44 0 33 0 66 
1 0 0 4 0 0 0 0 0 6 0 0 1 
33 0 44 0 55 0 22 0 55 0 44 0 33 
1 0 5 0 0 0 0 0 0 0 0 0 1 
66 0 33 0 44 0 55 0 22 0 55 0 44 
1 0 0 0 0 0 0 0 0 0 0 0 1 
1 0 66 0 33 0 44 0 55 4 22 0 55 
77 0 0 0 0 0 0 0 0 0 0 7 1 
1 1 77 1 66 1 33 1 44 1 55 1 22 