1 1 1 1 1 1 1 44 1 1 1 1 1 
1 0 0 0 0 0 0 0 0 0 0 0 1 
1 0 0 0 0 0 0 0 0 2 0 0 1 
1 0 0 0 0 0 0 0 0 0 0 0 55 
1 0 22 33 33 33 0 33 33 33 33 0 1 
1 0 33 0 0 0 0 33 0 0 33 0 1 
1 0 33 4 0 0 0 33 0 0 33 0 1 
1 0 33 33 33 33 0 33 33 33 33 0 1 
1 0 33 0 0 33 0 33 0 0 33 0 1 
1 0 33 0 0 33 0 33 0 0 33 0 1 
1 0 33 33 33 33 0 33 33 33 33 0 1 
1 0 0 0 0 0 5 0 0 0 0 0 1 
1 1 1 1 1 1 1 1 1 1 1 1 1 