13 13
44 1 1 1 1 1 44 33 22 1 1 1 44 
1 0 0 0 0 0 44 0 0 0 0 0 1 
1 0 0 0 0 0 44 0 0 0 0 0 1 
66 0 0 0 0 0 44 0 0 0 0 0 1 
55 0 0 0 0 0 44 0 0 0 0 0 1 
1 0 0 0 0 0 7 0 0 0 0 0 1 
1 0 0 0 0 0 0 44 44 44 44 44 44 
44 44 44 44 44 0 0 0 0 0 0 0 1 
1 0 0 0 0 0 0 0 0 0 0 0 77 
1 0 0 0 0 44 0 0 0 0 0 0 1 
1 3 2 0 0 44 0 0 0 0 0 0 1 
1 5 6 0 0 44 0 0 0 0 0 0 1 
44 1 1 1 1 44 1 1 1 1 1 1 44 