13 13
1 1 33 33 33 1 1 1 1 55 55 55 55 
1 1 1 1 33 33 33 1 1 55 1 1 1 
1 1 1 1 1 1 33 1 1 55 1 1 1 
1 1 1 5 0 0 0 0 6 0 1 44 44 
22 22 22 0 0 0 0 0 0 0 1 1 44 
22 1 1 0 0 7 1 0 0 0 1 1 44 
22 1 1 0 0 1 1 1 0 0 1 44 44 
22 22 1 0 0 0 1 0 0 0 44 44 1 
1 1 1 0 0 0 0 0 0 0 1 1 1 
1 1 1 4 66 0 2 0 0 3 1 1 1 
1 1 1 1 66 1 1 77 1 1 77 77 77 
66 66 1 66 66 1 1 77 1 77 77 1 77 
1 66 66 66 1 1 1 77 77 77 1 1 77 