13 13
66 1 66 1 66 1 66 1 66 1 66 1 66 
1 66 1 66 1 66 1 66 1 66 1 66 1 
77 1 0 0 0 0 0 0 6 0 7 1 77 
1 77 0 0 0 0 0 0 0 0 0 77 1 
77 1 0 0 0 0 0 0 0 0 0 1 77 
1 77 0 0 0 0 0 0 0 0 0 77 1 
77 1 0 0 6 0 1 0 0 0 0 1 77 
1 77 0 0 0 0 0 0 0 0 0 77 1 
77 1 0 0 0 0 0 0 0 0 0 1 77 
1 77 0 0 0 0 0 0 0 0 0 77 1 
77 1 7 0 0 0 0 0 0 0 0 1 77 
1 66 1 66 1 66 1 66 1 66 1 77 1 
66 1 66 1 66 1 66 1 66 1 66 1 77 