13 13
1 1 1 1 33 1 1 1 44 1 1 1 1 
1 0 0 0 0 0 0 0 0 0 0 0 1 
55 0 0 0 0 0 0 0 0 0 0 0 1 
1 0 0 0 0 0 0 0 0 0 0 0 1 
1 0 0 0 0 0 0 0 0 0 0 0 1 
1 0 0 0 0 0 0 0 0 0 0 0 1 
1 0 0 0 0 0 0 0 0 0 0 0 1 
1 0 0 0 0 0 0 0 0 0 0 0 1 
1 0 0 0 0 0 0 0 0 0 0 0 1 
22 0 0 0 0 22 22 0 0 0 0 0 1 
22 22 0 22 0 22 0 0 22 22 22 4 1 
22 0 3 22 5 22 0 0 22 0 22 0 22 
22 22 22 22 22 22 22 22 22 22 22 22 22 