13 13
1 1 22 1 1 1 66 1 1 1 1 1 1 
1 0 0 1 1 1 0 0 1 4 0 3 1 
44 0 0 1 1 1 0 0 1 0 0 0 1 
1 0 0 0 0 0 0 0 1 0 1 0 1 
1 0 6 1 0 1 2 0 33 0 0 0 1 
1 1 1 1 0 1 1 1 1 0 0 1 1 
1 1 1 0 0 0 0 0 0 0 0 0 1 
1 1 1 1 0 1 22 1 1 0 1 0 1 
1 0 0 1 0 1 0 0 1 0 0 0 1 
1 0 0 0 0 0 0 0 1 0 1 0 1 
55 0 0 1 1 1 0 0 1 0 0 0 1 
1 0 2 1 1 1 6 0 1 5 0 0 1 
1 66 1 1 1 1 1 1 1 1 1 1 1 