13 13
33 33 1 1 1 1 1 1 1 1 1 22 22 
33 33 0 0 0 0 1 0 0 0 0 22 22 
1 0 0 0 0 0 0 0 0 0 0 0 1 
1 0 0 1 1 1 4 1 1 1 0 0 1 
1 0 0 1 77 0 0 0 0 1 0 0 1 
1 0 0 1 0 0 0 0 0 1 0 0 1 
1 1 0 5 0 0 0 0 0 3 0 1 1 
1 0 0 1 0 0 0 0 0 1 0 0 1 
1 0 0 1 0 0 0 0 6 1 0 0 1 
1 0 0 1 1 1 2 1 1 1 0 0 1 
1 0 0 0 0 7 0 0 0 0 0 0 1 
44 44 0 0 0 0 1 0 0 0 0 55 55 
44 44 1 1 1 1 1 1 66 1 1 55 55 