13 13
1 1 1 1 1 1 1 1 1 1 1 1 1 
1 0 0 0 0 1 0 0 0 0 0 0 1 
1 0 0 0 0 0 0 0 0 0 1 0 1 
1 1 0 0 0 1 1 1 1 1 0 0 1 
1 0 0 0 0 0 33 1 1 1 0 0 1 
1 1 0 1 0 0 0 44 1 1 0 0 1 
1 0 0 1 66 0 0 0 55 1 0 0 1 
1 0 0 1 1 44 0 0 0 1 0 0 1 
1 0 0 1 1 1 33 0 0 0 0 6 77 
1 0 0 1 1 1 1 1 0 0 0 7 1 
1 0 1 0 0 0 0 0 0 0 0 0 1 
1 0 0 0 0 0 0 0 0 1 0 0 1 
1 1 1 1 1 1 1 1 1 1 1 1 1 