9 9
0 1 1 1 1 33 1 1 0 
1 1 0 0 4 0 0 1 1 
1 0 3 0 0 0 4 0 1 
1 5 0 0 0 0 0 0 1 
1 0 0 0 0 0 0 0 44 
1 0 0 0 0 0 0 0 1 
1 0 0 0 0 0 0 0 1 
1 1 0 0 0 0 0 1 1 
0 1 1 1 55 1 1 1 0 