13 13
1 1 33 33 33 33 33 33 33 33 33 1 1 
1 4 0 0 0 0 0 0 0 0 0 6 1 
33 0 0 0 0 0 0 1 1 1 1 0 33 
33 0 0 1 1 0 0 0 0 0 1 0 33 
33 0 0 1 0 0 0 0 0 0 0 0 33 
22 0 0 0 0 0 0 0 0 0 0 0 33 
33 0 1 0 0 0 0 44 0 1 0 0 33 
33 0 1 0 0 0 0 0 0 1 0 0 33 
33 0 1 0 0 0 0 0 0 1 0 0 33 
33 0 1 0 0 0 0 0 1 1 0 0 33 
33 0 1 1 0 0 0 0 0 0 0 0 33 
1 0 0 0 0 0 0 0 0 0 0 2 1 
1 1 33 33 66 33 33 33 33 33 33 1 1 