11 6
22 22 22 22 22 44 22 22 22 22 22 
22 0 0 0 0 0 0 0 0 0 22 
22 0 0 6 0 4 0 7 0 0 66 
77 0 0 0 0 0 0 0 0 0 22 
22 0 0 0 0 0 0 0 0 0 22 
22 22 22 22 22 22 22 22 22 22 22 