13 13
1 1 1 1 1 1 1 55 55 55 55 55 55 
1 0 0 0 0 0 0 1 55 55 55 55 55 
1 0 0 0 0 0 0 0 1 55 55 55 55 
1 0 0 44 0 0 0 0 0 1 55 55 55 
1 0 0 0 4 1 0 1 0 0 22 55 55 
1 0 0 0 1 1 0 1 1 0 0 1 55 
1 0 0 0 0 0 2 0 0 0 0 0 1 
55 1 0 0 1 1 0 1 1 0 0 0 1 
55 55 1 0 0 1 0 1 7 0 0 0 1 
55 55 55 1 0 0 0 0 0 77 0 0 1 
55 55 55 55 1 0 0 0 0 0 0 0 1 
55 55 55 55 55 1 0 0 0 0 0 0 1 
55 55 55 55 55 55 1 1 1 1 1 1 1 