13 13
1 1 1 1 1 1 1 1 1 1 1 1 1 
77 3 0 0 0 0 0 0 0 0 0 0 44 
1 0 0 0 0 0 0 0 0 0 0 0 1 
1 0 0 1 0 1 4 1 0 1 0 0 1 
1 0 0 1 1 1 1 1 1 33 0 0 1 
1 0 0 1 0 1 1 1 0 1 0 0 1 
1 0 0 1 1 1 55 1 1 1 0 0 1 
1 5 0 1 1 1 0 1 1 1 0 0 1 
1 1 0 0 0 0 0 0 0 0 0 1 1 
1 1 1 1 1 1 0 22 1 1 1 1 1 
1 0 0 0 0 0 0 0 0 0 0 0 1 
1 7 0 0 0 0 0 0 0 0 0 2 1 
1 1 1 1 1 1 1 1 1 1 1 1 1 