9 9
1 1 1 22 1 1 1 1 1 
1 0 0 0 0 0 0 0 1 
1 0 0 0 0 0 0 0 1 
1 0 0 0 0 0 0 0 1 
55 0 0 0 3 4 0 0 1 
1 0 0 0 2 5 0 0 33 
1 0 0 0 0 0 0 0 1 
1 0 0 0 0 0 0 0 1 
1 1 1 1 44 1 1 1 1 