13 13
0 0 0 0 0 1 1 33 1 0 0 0 0 
0 0 1 1 55 1 0 0 1 77 1 1 1 
0 0 1 0 0 0 2 0 0 0 0 0 1 
0 0 1 0 0 0 0 0 0 0 7 0 1 
1 1 1 0 0 0 0 5 0 0 0 1 1 
1 0 0 0 6 1 66 1 1 0 0 1 0 
1 0 4 0 0 1 0 0 44 0 0 1 0 
1 0 0 1 1 1 0 0 1 0 0 1 0 
1 1 1 1 0 0 0 0 1 0 0 1 0 
0 0 0 0 0 1 1 22 1 0 0 1 0 
0 0 0 0 0 1 0 0 0 0 0 1 0 
0 0 0 0 0 1 0 0 3 0 0 1 0 
0 0 0 0 0 1 1 1 1 1 1 1 0 