11 11
1 1 1 1 1 1 1 33 1 1 1 
1 0 0 0 0 0 0 0 0 0 1 
1 0 0 0 0 0 0 0 0 0 1 
1 0 0 1 1 0 1 1 0 0 44 
1 0 1 1 0 0 0 1 1 0 1 
77 0 0 4 6 0 7 3 0 0 66 
1 0 1 1 0 0 0 1 1 0 1 
1 0 0 1 1 0 1 1 0 0 1 
1 0 0 0 0 0 0 0 0 0 1 
1 0 0 0 0 0 0 0 0 0 1 
1 1 1 1 1 1 1 1 1 1 1 