13 12
0 1 1 1 0 0 0 1 1 1 1 1 0 
0 1 0 1 1 1 1 1 0 0 0 1 0 
0 1 0 0 0 0 0 0 0 1 0 1 0 
0 22 0 1 0 1 1 0 0 0 0 1 0 
0 1 0 1 0 0 1 1 1 1 0 1 0 
0 1 0 1 1 0 0 1 0 1 0 1 0 
0 1 0 1 0 0 0 0 0 1 0 1 0 
0 1 0 1 1 1 0 0 0 1 0 1 0 
0 1 0 0 0 1 1 1 0 1 0 1 0 
1 1 0 1 0 1 0 0 0 1 0 1 1 
1 6 0 0 0 0 0 0 0 0 0 2 1 
1 1 1 1 1 1 1 1 1 1 66 1 1 