13 13
1 1 1 1 1 1 1 1 44 1 1 1 1 
1 0 1 0 0 0 0 0 0 0 0 0 1 
1 0 0 0 1 1 1 0 0 0 0 1 1 
1 0 1 1 1 5 1 1 1 0 1 1 1 
1 0 0 0 0 3 0 0 0 0 0 0 1 
1 0 1 1 1 4 1 1 1 0 1 1 1 
1 0 1 33 1 2 1 55 1 0 1 0 1 
1 0 1 0 1 0 1 0 0 0 1 0 1 
1 0 1 0 0 0 0 0 1 0 0 0 22 
1 0 1 0 1 0 1 0 1 1 1 0 1 
1 0 1 1 1 0 1 0 0 0 0 0 1 
1 0 0 0 0 0 0 0 1 1 1 0 1 
1 1 1 1 1 1 1 1 1 1 1 1 1 