12 13
1 1 1 1 1 1 1 1 1 1 1 1 
1 0 0 0 0 0 0 0 0 0 0 1 
1 0 1 1 1 0 1 0 1 1 0 1 
1 0 5 1 0 0 1 0 1 2 0 1 
1 0 1 0 1 0 1 0 1 6 0 1 
1 0 1 1 1 0 1 1 1 1 0 1 
1 0 0 0 0 0 0 0 0 0 0 66 
22 0 0 1 1 0 0 1 1 0 0 1 
1 0 1 1 0 0 0 0 1 1 0 1 
1 1 1 0 0 0 0 0 0 1 1 1 
1 1 0 0 0 0 0 0 0 0 1 1 
1 0 0 0 0 0 0 0 0 0 0 1 
1 1 1 1 1 1 1 55 1 1 1 1 