11 11
1 1 1 33 1 1 1 1 1 1 1 
1 3 0 0 0 0 0 0 0 5 1 
1 0 1 0 1 1 1 0 1 0 1 
1 0 1 0 0 0 1 0 1 0 1 
1 0 1 1 0 1 1 0 1 0 1 
1 0 0 0 0 0 0 0 1 0 1 
1 0 1 1 1 0 1 1 1 0 55 
1 0 1 44 0 0 0 0 0 0 1 
1 0 1 1 1 1 0 1 1 0 1 
1 4 0 0 0 0 0 0 0 7 1 
1 1 1 1 1 1 77 1 1 1 1 