13 13
1 1 1 1 1 1 1 1 22 1 1 1 1 
1 0 1 1 0 0 0 0 0 0 0 0 1 
1 0 1 1 0 0 0 0 0 0 0 0 1 
1 0 1 1 1 1 0 0 0 0 0 0 1 
1 0 0 1 1 1 1 0 0 0 0 0 1 
1 0 0 1 0 1 1 0 1 1 0 0 1 
1 0 0 0 0 0 0 0 0 0 0 0 55 
1 0 0 0 1 1 1 0 1 1 0 0 1 
1 4 1 0 0 1 1 0 1 1 1 0 1 
1 5 1 0 0 0 1 0 1 1 1 1 1 
1 2 1 0 0 0 0 0 0 0 1 1 1 
1 0 0 0 0 0 0 0 0 0 0 0 1 
1 1 1 1 1 1 44 1 1 1 1 1 1 