13 13
1 1 66 1 1 1 33 1 1 1 1 1 1 
1 7 0 0 0 1 0 1 0 0 0 0 1 
1 0 0 0 0 0 0 0 0 0 0 0 1 
1 0 0 0 0 0 0 0 0 0 0 0 1 
1 0 0 0 4 1 0 1 3 0 0 0 1 
1 1 0 0 1 1 0 1 1 0 0 1 1 
22 0 0 0 0 0 0 0 0 0 0 0 44 
1 1 0 0 1 1 0 1 1 0 0 1 1 
1 0 0 0 5 1 0 1 2 0 0 0 1 
1 0 0 0 0 0 0 0 0 0 0 0 1 
1 0 0 0 0 0 0 0 0 0 0 0 77 
1 0 0 0 0 1 0 1 0 0 0 6 1 
1 1 1 1 1 1 55 1 1 1 1 1 1