11 13
0 1 1 1 1 1 1 1 1 1 0 
1 1 0 0 0 1 0 0 0 1 1 
44 0 0 0 0 0 0 0 0 0 1 
1 0 0 0 0 0 0 0 0 0 22 
1 0 0 0 0 0 0 0 0 0 1 
1 1 5 0 0 0 0 0 3 1 1 
0 1 1 1 1 0 1 1 1 1 0 
1 1 2 0 0 0 0 0 4 1 1 
1 0 0 0 0 0 0 0 0 0 1 
1 0 0 0 0 0 0 0 0 0 55 
33 0 0 0 0 0 0 0 0 0 1 
1 1 0 0 0 1 0 0 0 1 1 
0 1 1 1 1 1 1 1 1 1 0 