13 13
1 1 1 1 1 1 1 1 1 1 1 1 1 
1 0 0 0 0 0 0 0 0 0 0 0 1 
1 0 3 1 1 1 1 1 1 1 1 0 1 
1 0 1 1 0 0 0 0 0 0 0 0 1 
1 0 1 0 0 1 1 1 1 1 0 0 1 
1 0 1 0 0 0 0 0 33 1 1 0 1 
1 5 1 0 0 0 0 0 0 55 1 0 1 
1 0 1 0 0 0 0 0 66 1 1 0 1 
1 0 1 0 0 1 1 1 1 1 0 0 1 
1 0 1 1 0 0 0 0 0 0 0 0 1 
1 0 6 1 1 1 1 1 1 1 1 0 1 
1 0 0 0 0 0 0 0 0 0 0 0 1 
1 1 1 1 1 1 1 1 1 1 1 1 1 