13 13
0 1 1 1 1 1 1 1 1 1 1 1 0 
1 0 0 0 0 0 0 0 0 0 0 0 1 
1 0 0 0 0 1 1 1 0 0 0 0 1 
1 0 0 0 0 0 0 0 0 0 0 0 1 
1 0 0 0 1 1 2 1 1 0 0 0 1 
1 0 1 0 66 0 0 0 1 0 1 0 1 
1 0 1 0 7 0 0 0 6 0 1 0 1 
1 0 1 0 1 0 0 0 1 0 1 0 1 
1 0 0 0 1 1 5 1 1 0 0 0 1 
1 0 0 0 0 0 0 0 0 0 0 0 22 
1 0 0 0 0 55 1 1 0 0 0 0 1 
1 0 0 0 0 0 0 0 0 0 0 0 1 
0 1 1 77 1 1 1 1 1 1 1 1 0 