13 13
1 1 1 1 1 1 1 1 1 1 1 1 1 
1 0 0 0 0 0 1 3 0 0 0 0 1 
1 0 0 0 0 0 0 0 0 2 0 0 1 
1 0 4 1 0 1 1 1 1 1 0 0 1 
1 0 0 1 0 0 0 0 0 1 0 0 1 
1 0 5 1 0 0 1 0 0 1 0 0 1 
1 0 1 1 1 1 1 0 0 1 1 0 1 
1 0 0 1 0 0 0 0 0 1 0 0 1 
1 0 0 1 0 44 1 0 0 1 0 1 1 
1 0 0 1 1 1 1 1 1 22 0 1 1 
1 0 0 0 0 0 1 55 0 1 0 1 1 
1 0 1 0 0 0 0 0 0 1 0 0 1 
1 1 1 1 33 1 1 1 1 1 1 1 1