13 13
0 0 0 0 0 1 66 1 0 0 0 0 0 
0 0 1 1 1 1 0 1 1 55 1 0 0 
0 1 1 0 0 0 0 0 0 0 1 1 0 
0 1 0 0 0 0 0 0 0 0 0 1 0 
0 1 0 0 0 1 0 1 0 0 0 1 0 
1 1 0 0 1 1 0 1 1 0 0 1 1 
1 6 0 0 0 0 0 0 0 0 0 0 33 
1 1 0 0 1 1 0 1 1 0 0 1 1 
0 1 0 7 0 1 0 1 0 0 0 1 0 
0 1 0 0 5 0 0 0 0 0 0 77 0 
0 1 1 0 0 0 0 0 0 0 1 1 0 
0 0 1 1 1 1 3 1 1 1 1 0 0 
0 0 0 0 0 1 1 1 0 0 0 0 0 