13 13
1 1 1 0 0 0 0 0 0 0 0 0 0 
1 5 1 1 1 1 1 1 1 1 1 0 0 
1 0 0 0 0 0 0 0 0 0 1 1 0 
1 0 1 1 1 1 1 1 1 0 0 1 0 
1 0 1 0 0 0 0 0 0 1 0 1 0 
1 0 0 0 0 0 55 0 0 1 0 1 0 
1 0 0 0 0 0 0 0 0 1 0 1 0 
1 0 1 1 1 1 1 0 1 1 0 1 0 
1 0 0 0 1 0 0 0 0 0 0 1 0 
1 0 1 0 0 0 1 0 0 1 1 1 0 
1 0 1 1 0 0 1 1 1 1 0 1 1 
1 4 0 0 0 0 0 0 0 0 0 0 1 
1 1 1 1 1 44 1 1 1 1 1 1 1 