8 8
0 0 1 44 1 1 0 0 
0 0 1 0 2 1 0 0 
1 1 1 0 0 1 1 1 
22 0 0 0 0 0 3 1 
1 4 0 0 0 0 0 55 
1 1 1 0 0 1 1 1 
0 0 1 5 0 1 0 0 
0 0 1 1 33 1 0 0 