13 13
1 1 1 1 1 1 1 1 1 1 1 1 1 
1 0 0 0 0 0 0 0 0 0 0 0 1 
1 0 0 0 0 0 0 1 1 1 0 0 1 
1 0 1 1 1 0 0 3 22 1 0 0 1 
1 0 1 55 4 0 0 1 1 1 0 0 1 
1 0 1 1 1 0 0 0 0 0 0 0 1 
1 0 0 0 0 0 0 0 0 0 0 0 1 
1 0 0 0 0 0 0 0 1 1 1 0 1 
1 0 0 1 1 1 0 0 5 44 1 0 1 
1 0 0 1 33 2 0 0 1 1 1 0 1 
1 0 0 1 1 1 0 0 0 0 0 0 1 
1 0 0 0 0 0 0 0 0 0 0 0 1 
1 1 1 1 1 1 1 1 1 1 1 1 1 
