13 8
1 1 1 1 1 1 33 1 1 1 1 1 1 
1 0 0 0 0 0 0 0 0 0 0 0 1 
1 0 0 0 0 0 0 0 0 0 0 0 1 
1 0 0 0 0 0 0 0 0 0 0 0 44 
55 0 0 0 0 0 0 0 0 0 0 0 1 
1 0 0 0 1 1 22 1 1 0 0 0 1 
1 5 0 2 1 0 0 0 1 3 0 4 1 
1 1 1 1 1 0 0 0 1 1 1 1 1 