13 13
33 33 33 33 33 33 33 33 33 33 33 33 33 
33 44 66 44 0 44 0 44 0 44 22 44 33 
33 0 0 0 0 0 0 0 0 0 0 0 33 
33 44 0 0 0 0 0 0 0 0 0 44 33 
33 5 0 0 0 6 0 0 0 0 0 0 33 
33 44 0 0 0 0 0 0 0 0 0 44 33 
33 0 0 0 0 0 0 0 0 0 0 0 33 
33 44 0 0 0 0 0 0 0 0 0 44 33 
33 0 0 2 0 0 0 0 0 0 0 5 33 
33 44 0 0 0 0 0 6 0 0 0 44 33 
33 0 0 0 0 0 0 0 0 0 2 1 33 
33 44 1 44 1 44 0 44 55 44 0 44 33 
33 33 33 33 33 33 33 33 33 33 33 33 33 